Other
=======================================
Snowball	|| weapon_snowball
Zeus x27	|| weapon_taser
Ballistic Shield	|| weapon_shield
Breach Charge	|| weapon_breachcharge
Bump Mine	|| weapon_bumpmine
Medi-Shot	|| weapon_healthshot
Fists	|| weapon_fists
Tablet	|| weapon_tablet
C4	|| weapon_c4
Tablet	|| weapon_tablet
Gold Knife	|| weapon_knifegg
Knife	|| weapon_knife

Grenades
=======================================
High-explosive Grenade	|| weapon_hegrenade
Decoy Grenade	|| weapon_decoy
Flashbang Grenade	|| weapon_flashbang
Smoke Grenade	|| weapon_smokegrenade
Molotov Grenade	|| weapon_molotov
Incendiary Grenade	|| weapon_incgrenade
Tag Grenade	|| weapon_tagrenade

Pistols
=======================================
Glock-18	|| weapon_glock
Dual Berettas	|| weapon_elite
P250	|| weapon_p250
Tec-9	|| weapon_tec9
CZ75-Auto	|| weapon_cz75a
Desert Eagle	|| weapon_deagle
R8 Revolver	|| weapon_revolver
USP-S	|| weapon_usp_silencer
P2000	|| weapon_hkp2000
Five-Seven	|| weapon_fiveseven

Shotguns
=======================================
Nova	|| weapon_nova
XM1014	|| weapon_xm1014
Sawed-Off	|| weapon_sawedoff
MAG-7	|| weapon_mag7
Molotov Grenade	|| weapon_molotov

SMGs
=======================================
MAC-10	|| weapon_mac10
MP7	|| weapon_mp7
UMP-45	|| weapon_ump45
P90	|| weapon_p90
PP-Bizon	|| weapon_bizon
MP9	|| weapon_mp9
MP5-SD	|| weapon_mp5sd

Assault Rifles
=======================================
Galil AR	|| weapon_galilar
AK-47	|| weapon_ak47
SG 553	|| weapon_sg556
FAMAS	|| weapon_famas
M4A4	|| weapon_m4a4
M4A1-S	|| weapon_m4a1_silencer
AUG	|| weapon_aug

Sniper Rifles
=======================================
SSG 08	|| weapon_ssg08
AWP	|| weapon_awp
G3SG1	|| weapon_g3sg1
SCAR-20	|| weapon_scar20
Machine Guns
Machine Gun	Command
M249	|| weapon_m249
Negev	|| weapon_negev